8 -1 -1 4 -1 6 -1 -1 7
-1 -1 -1 -1 -1 -1 4 -1 -1
-1 1 -1 -1 -1 -1 6 5 -1
5 -1 9 -1 3 -1 7 8 -1
-1 -1 -1 -1 7 -1 -1 -1 -1
-1 4 8 -1 2 -1 1 -1 3
-1 5 2 -1 -1 -1 -1 9 -1
-1 -1 1 -1 -1 -1 -1 -1 -1
3 -1 -1 9 -1 2 -1 -1 5